1111111111111111111111
1800000000000000000081
1010111111001111110101
1010111111001111110101
1010000009999000000101
1010111011771101110101
1010180013456100810101
1010111011111101110101
1000000000000000000001
1101011101111011101011
9001011101111011101009
9001008100000018001009
1101011111001111101011
1800000000000000000081
1011111011111101111101
1010000000000000000101
1010111011001101110101
1010181011001101810101
1010001011901101000101
1011111011111101111101
1200000000000000000001
1111111111111111111111
--