1111111111111111111111
1000000000000000000001
1011110111001110111101
1011810111001110181101
1011010000000000101101
1000010011771100100001
1000010013456100100001
1011010011111100101101
1001010110000110101001
1101010100110010101011
9000000001111000000009
9000000100110010000009
1101101110000111011011
1000101800110081010001
1010000011111100000101
1011111000110001111101
1000000010000100000001
1010001011001101000101
1008100011901100018001
1010001000000001000101
1200000000000000000001
1111111111111111111111
--